FFFFFFFFFFFFFFFFFFFF
FFFFFFFFFFFFFFFFFFFF
FFFFFFFFWWWWFFFFFFFF
FFFFFFFFWFEWFFFFFFFF
FFFFFWWWWFFWFFFFFFFF
FFFFFWFFFFFWFFFFFFFF
FFFFFWFBFWFWFFFFFFFF
FFFFFWWWFFFWFFFFFFFF
FFFFFFFWWFFWWFFFFFFF
FFFFFFFFWFFFWWWFFFFF
FFFFFFFFWPWFBFWFFFFF
FFFFFFFFWFFFFFWFFFFF
FFFFFFFFWFFWWWWFFFFF
FFFFFFFFWEFWFFFFFFFF
FFFFFFFFWWWWFFFFFFFF
FFFFFFFFFFFFFFFFFFFF
FFFFFFFFFFFFFFFFFFFF
FFFFFFFFFFFFFFFFFFFF
FFFFFFFFFFFFFFFFFFFF
FFFFFFFFFFFFFFFFFFFF