FFFFFFFFFFFFFFFFFFFF
FFFFFFFFFFFFFFFFFFFF
FFFFFFFFFFFFFFFFFFFF
FFFFFFFFFFFFFFFFFFFF
FFFFFFFFFFFFFFFFFFFF
FFFFFFFFFFFFFFFFFFFF
FFFFFFFFFFFFFFFFFFFF
FFFFFFFFFFFFFFFFFFFF
FFFWWWWWWWFFFFFFFFFF
FFFWFFFFFWWWFFFFFFFF
FFFWFFPBBEEWFFFFFFFF
FFFWWWWFWWFWFFFFFFFF
FFFFFWFFFFFWFFFFFFFF
FFFFFWFFWWWWFFFFFFFF
FFFFFWFFWFFFFFFFFFFF
FFFFFWWWWFFFFFFFFFFF
FFFFFFFFFFFFFFFFFFFF
FFFFFFFFFFFFFFFFFFFF
FFFFFFFFFFFFFFFFFFFF
FFFFFFFFFFFFFFFFFFFF
