FFFFFFFFFFFFFFFFFFFF
FFFFFFFFFFFFFFFFFFFF
FFFFFFFFFFFFFFFFFFFF
FFFWWWWWWWWFFFFFFFFF
FFFWFFPFBEWWWWFFFFFF
FFFWWWWFFFWFEWFFFFFF
FFFFWWWFBEWFEWFFFFFF
FFFFWFFFFFWFEWFFFFFF
FFFFWFBFBFBFFWFFFFFF
FFFFWFFFFFWFFWFFFFFF
FFFFWWWWWWWWWWFFFFFF
FFFFFFFFFFFFFFFFFFFF
FFFFFFFFFFFFFFFFFFFF
FFFFFFFFFFFFFFFFFFFF
FFFFFFFFFFFFFFFFFFFF
FFFFFFFFFFFFFFFFFFFF
FFFFFFFFFFFFFFFFFFFF
FFFFFFFFFFFFFFFFFFFF
FFFFFFFFFFFFFFFFFFFF
FFFFFFFFFFFFFFFFFFFF