FFFFFFFFFFFFFFFFFFFF
FFFFFFFFFFFFFFFFFFFF
FFFFFFFFFFFFFFFFFFFF
FFFFFFFFFFFFFFFFFFFF
FFFFFFFFFFFFFFFFFFFF
FFFFFFFFFFFFFFFFFFFF
FFWWWWWWWWWWWWFFFFFF
FFWEEEWPWWFFFWFFFFFF
FFWEEFWFFWBWFWFFFFFF
FFWEFFWFFWFFFWFFFFFF
FFWWFBWFBFBFFWFFFFFF
FFWFFBFBFWWFFWFFFFFF
FFWFFFFFFFFFFWFFFFFF
FFWWWWWWWWWWWWFFFFFF
FFFFFFFFFFFFFFFFFFFF
FFFFFFFFFFFFFFFFFFFF
FFFFFFFFFFFFFFFFFFFF
FFFFFFFFFFFFFFFFFFFF
FFFFFFFFFFFFFFFFFFFF
FFFFFFFFFFFFFFFFFFFF