FFFFFFFFFFFFFFFFFFFF
FFFFFFFFFFFFFFFFFFFF
FFFFFFFFFFFFFFFFFFFF
FFFFFFFFFFFFFFFFFFFF
FFFFFFWWWWWWWWFFFFFF
FFFFFFWFFFFFFWFFFFFF
FFFFFFWFBFBFFWFFFFFF
FFFFFFWFFBFBFWFFFFFF
FFFWWWWWFFFFWWWWWFFF
FFFWFFWFFFFFFWFFWFFF
FFFWEFFFFFFFFFFEWFFF
FFFWFFWFFFFFFWFFWFFF
FFFWWWWWFFFFWWWWWFFF
FFFFFFWFFFFFFWFFFFFF
FFFFFFWEFFFFEWFFFFFF
FFFFFFWPFFFFFWFFFFFF
FFFFFFWWWWWWWWFFFFFF
FFFFFFFFFFFFFFFFFFFF
FFFFFFFFFFFFFFFFFFFF
FFFFFFFFFFFFFFFFFFFF