FFFFFFFFFFFFFFFFFFFF
FFFFFFFFFFFFFFFFFFFF
FFFFFFFFFFFFFFFFFFFF
FFFFFFFFFFFFFFFFFFFF
FFFFFFFFFFFFFFFFFFFF
FFFFFFFFWWWWFFFFFFFF
FFFFFFFFWFFWFFFFFFFF
FFFFFWWWWBFWWFFFFFFF
FFFFFWEFBFFFWFFFFFFF
FFFFFWEFBFBFWFFFFFFF
FFFFFWEEWFFFWFFFFFFF
FFFFFWEEWBBWWFFFFFFF
FFFFFWWWWFFWFFFFFFFF
FFFFFFFFWPFWFFFFFFFF
FFFFFFFFWWWWFFFFFFFF
FFFFFFFFFFFFFFFFFFFF
FFFFFFFFFFFFFFFFFFFF
FFFFFFFFFFFFFFFFFFFF
FFFFFFFFFFFFFFFFFFFF
FFFFFFFFFFFFFFFFFFFF