FFFFFFFFFFFFFFFFFFFF
FFFFFFFFFFFFFFFFFFFF
FFFFFFFFWWWWWFFFFFFF
FWWWWWWWWFFFWWWWWWWF
FWFFFFWFFFFFWEWEWEWF
FWFFWBWFFFWBWFWFWFWF
FWFFFBFFFFWFFFFFFFWF
FWFFFFFFFWFFFFFFFFWF
FWFWWWWWWWFFFFFFFFWF
FWFFFFFFFFWFFFFFFFWF
FWFFPFFFFBWBWFWFWFWF
FWFFFFFFBFFFWEWEWEWF
FWWWWWWWWFFFWWWWWWWF
FFFFFFFFWWWWWFFFFFFF
FFFFFFFFFFFFFFFFFFFF
FFFFFFFFFFFFFFFFFFFF
FFFFFFFFFFFFFFFFFFFF
FFFFFFFFFFFFFFFFFFFF
FFFFFFFFFFFFFFFFFFFF
FFFFFFFFFFFFFFFFFFFF

