FFFFFFFFFFFFFFFFFFFF
FFFFFFFFFFFFFFFFFFFF
FFFFFFFFFFFFFFFFFFFF
FFFFFFFFFFFFFFFFFFFF
FFFFFFFWWWWWWFFFFFFF
FFFFFFFWFEEPWFFFFFFF
FFFFFFFWFBBFWFFFFFFF
FFFFFFFWWFWWWFFFFFFF
FFFFFFFFWFWFFFFFFFFF
FFFFFFFFWFWFFFFFFFFF
FFFFFWWWWFWFFFFFFFFF
FFFFFWFFFFWWFFFFFFFF
FFFFFWFWFFFWFFFFFFFF
FFFFFWFFFWFWFFFFFFFF
FFFFFWWWFFFWFFFFFFFF
FFFFFFFWWWWWFFFFFFFF
FFFFFFFFFFFFFFFFFFFF
FFFFFFFFFFFFFFFFFFFF
FFFFFFFFFFFFFFFFFFFF
FFFFFFFFFFFFFFFFFFFF