FFFFFFFFFFFFFFFFFFFF
FFFFFFFFFFFFFFFFFFFF
FFFFFFFFFFFFFFFFFFFF
FFFFFFFWWWWWFFFFFFFF
FFFFFFWWFFFWWFFFFFFF
FFFFFWWFFBFFWWFFFFFF
FFFFFWFFBFBFFWFFFFFF
FFFFWWFFFPFFFWWFFFFF
FFFFWFFFFWFFFFWFFFFF
FFFFWFFFWWWFFFWFFFFF
FFFFWFFFFWFFFFWFFFFF
FFFFWFFFFFFFFFWFFFFF
FFFFWWFFEFEFFWWFFFFF
FFFFFWWFFEFFWWFFFFFF
FFFFFFWWFFFWWFFFFFFF
FFFFFFFWWWWWFFFFFFFF
FFFFFFFFFFFFFFFFFFFF
FFFFFFFFFFFFFFFFFFFF
FFFFFFFFFFFFFFFFFFFF
FFFFFFFFFFFFFFFFFFFF