FFFFFFFFFFFFFFFFFFFF
FFFFFFFFFFFFFFFFFFFF
FFFFFFFFFFFFFFFFFFFF
FFFFFFFFFFFFFFFFFFFF
FFFFFWWWWWWWFFFFFFFF
FFFFWWFEEEEWFFFFFFFF
FFFFWFFFWWWWWWFFFFFF
FFFFWFFFBFBFPWFFFFFF
FFFFWFFFFBFBFWFFFFFF
FFFFWWWWWWFFFWFFFFFF
FFFFFFFFFWWWWWFFFFFF
FFFFFFFFFFFFFFFFFFFF
FFFFFFFFFFFFFFFFFFFF
FFFFFFFFFFFFFFFFFFFF
FFFFFFFFFFFFFFFFFFFF
FFFFFFFFFFFFFFFFFFFF
FFFFFFFFFFFFFFFFFFFF
FFFFFFFFFFFFFFFFFFFF
FFFFFFFFFFFFFFFFFFFF
FFFFFFFFFFFFFFFFFFFF