FFFFFFFFFFFFFFFFFFFF
FFFFFFFFFFFFFFFFFFFF
FFFFFFFFFFFFFFFFFFFF
FFFFFFFFFFFFFFFFFFFF
FFFFFFFFFFFFFFFFFFFF
FFFFFFWWWWWFFFFFFFFF
FFFFFFWEWEWFFFFFFFFF
FFFFFFWFWFWFFFFFFFFF
FFFFFFWFFFWWWFFFFFFF
FFFFFFWFBEFFWFFFFFFF
FFFFFFWBBWFFWFFFFFFF
FFFFFFWPBFFFWFFFFFFF
FFFFFFWWWWFEWFFFFFFF
FFFFFFFFFWWWWFFFFFFF
FFFFFFFFFFFFFFFFFFFF
FFFFFFFFFFFFFFFFFFFF
FFFFFFFFFFFFFFFFFFFF
FFFFFFFFFFFFFFFFFFFF
FFFFFFFFFFFFFFFFFFFF
FFFFFFFFFFFFFFFFFFFF