FFFFFFFFFFFFFFFFFFFF
FFFFFFFFFFFFFFFFFFFF
FFFFFFFFFFWWWWFFFFFF
FFFFFFFFFFWFFWFFFFFF
FFFFFFWWWWWFBWFFFFFF
FFFFFFWFFEFFFWFFFFFF
FFFFFFWPEEEFFWFFFFFF
FFFFFFWFFEFFFWWWWFFF
FFFFFFWWWWWFFFFFWFFF
FFFFFFFFFFWFFFFFWFFF
FFFFFFFFFFWWFFFFWFFF
FFFFFFFFFFWFFFFFWFFF
FFFFFFFWWWWFFFFFWFFF
FFFFFFFWFFWBFWWWWFFF
FFFFFFFWFFBFBWFFFFFF
FFFFFFFWFFFBFWFFFFFF
FFFFFFFWFFFFFWFFFFFF
FFFFFFFWWWWWWWFFFFFF
FFFFFFFFFFFFFFFFFFFF
FFFFFFFFFFFFFFFFFFFF