FFFFFFFFFFFFFFFFFFFF
FFFFFFFFFFFFFFFFFFFF
FFFFFFFFFFFFFFFFFFFF
FFWWWWWWFFFFFFFFFFFF
FFWEEEEWFFFFFFFFFFFF
FFWEEWEWWWWWWFFFFFFF
FFWEEEPWWFFFWFFFFFFF
FFWEEEFWFBFFWWFFFFFF
FFWFBFWWFBFFFWFFFFFF
FFWFWFBFFFBWFWFFFFFF
FFWFFBFWBWFBFWFFFFFF
FFWWWWFBFBFFFWFFFFFF
FFFFFWWWFFFFWWFFFFFF
FFFFFFFWFFBFWFFFFFFF
FFFFFFFWBFBWWFFFFFFF
FFFFFFFWFFFWFFFFFFFF
FFFFFFFWWWWWFFFFFFFF
FFFFFFFFFFFFFFFFFFFF
FFFFFFFFFFFFFFFFFFFF
FFFFFFFFFFFFFFFFFFFF
